1111111111
10000000C1
10000000C1
1110000011
1P101E10C1
1111111111