1111111
1P00CE0
1P00001
1111111