1111111111
10000001C1
10001111C1
1P001E00C1
1111111111