1111111
1000CE1
1P000001
1111111